                                                                                        
        ┏━━━━━━━━━━━━━━━━━━━━━━━━━━━━━━━━━━━━━━━━━━━━━━━━━━━━━━━━━━━━━━━━━━━━━━━━━━━━━━┓
        ┃                               __  __   _   ___                               ┃
        ┃                              |  \/  | /_\ | _ \                              ┃
        ┃                              | |\/| |/ _ \|  _/                              ┃
        ┃                              |_|  |_/_/ \_\_|                                ┃
        ┃                                                                              ┃
        ┃                                                                              ┃
        ┃                                                                              ┃
        ┃     You are here, really where you are already when you think about.         ┃
        ┃                                                                              ┃
        ┃                                                                              ┃
        ┃                                                                              ┃
        ┗━━━━━━━━━━━━━━━━━━━━━━━━━━━━━━━━━━━━━━━━━━━━━━━━━━━━━━━━━━━━━━━━━━━━━━━━━━━━━━┛
                                                                                        
                                                                                        
                                                                                        
                                                               ┌───────────┐            
                                                               │           │            
                                                               │           ▼            
                                                               │      ┌─────────┐       
           ───────┐                                            │      │         │       
                  │                                            │      │ cell 1  │       
                  │       ┌──────────────────────────────┐     │      │         │       
                  │       │                              │     │      └─────────┘       
                  └──────▶│                              │     │                        
                          │                              │─────┘                        
           ──────────────▶│                              │            ┌─────────┐       
                          │                              │            │         │       
           ──────────────▶│          main room           │───────────▶│ cell 2  │       
                          │                              │            │         │       
           ──────────────▶│                              │            └─────────┘       
                          │                              │─────┐                        
                  ┌──────▶│                              │     │                        
                  │       │                              │     │      ┌─────────┐       
                  │       └──────────────────────────────┘     │      │         │       
                  │                                            │      │ cell 3  │       
           ───────┘                                            │      │         │       
                                                               │      └─────────┘       
                                                               │           ▲            
                                                               │           │            
                                                               └───────────┘            